
  ㄱ : 기린, 강아지, 개미, 고라니, 게, 가재, 거북이, 곰
  ㄴ : 나비, 너구리, 늑대, 낙타, 너구리
  ㄷ : 다람쥐, 도마뱀, 두더쥐, 돼지
  ㄹ : 라마, 라이거
  ㅁ : 물고기, 매, 말, 메뚜기, 미어캣
  ㅂ : 병아리, 박쥐, 비둘기, 뱀, 벌, 비버
  ㅅ : 사자, 소, 새우, 사슴, 상어, 소라
  ㅇ : 얼룩말, 오리, 여우, 악어, 앵무새, 이구아나
  ㅈ : 재규어, 족제비, 잠자리, 제비, 쥐
  ㅊ : 청설모, 참새, 청둥오리, 치타
  ㅋ : 캥거루, 코알라, 카멜레온, 코끼리
  ㅌ : 토끼, 타조, 타란튤라
  ㅍ : 표범, 파랑새, 파리, 펭귄, 퓨마
  ㅎ : 하마, 하늘소, 해마, 해파리, 홍학

  A : Alligator, Ant
  B : Bear, Bat, Bull, Bee
  C : Cat, Chicken, Cow, Crow, Camel
  D : Dog, Donkey, Dolphin, Duck
  E : Elephant, Eagle
  F : Frog, Fox
  G : Giraffe, Goat, Gorilla
  H : Hippo, Horse
  I : Iguana
  J : Jaguar
  K : Kangaroo, Koala, Killer while
  L : Lion
  M : Monkey, Mouse, Makaw
  N : Narwhal, Newt
  O : Octopus
  P : Pig, Panda, Penguin
  Q : Quail, Queen Bee
  R : Rabbit, Rhinoceros
  S : Shark, Sheep, Spider, Snake, Scorpion
  T : Turtle, Tiger, Tortoise
  U : Unicorn
  V : Viper, Vole, Vulture
  W : Whale, Wolf
  X : X-ray fish
  Y : Yak
  Z : Zebra


 http://a-z-animals.com/animals/
 http://animal.memozee.com/animal/Dic/
  